Give the English pronouns equivalent to each of the following Latin personal endings:
1    -t   = he, she, it

     -mus = we

     -ō   = I

     -nt  = they

     -s   = you (singular)

     -tis = you (plural)

Name the following forms and translate each
The forms are present active infinitives of the 2nd conjugation.
2    monēre = to advise / warn

     vidēre = to see

     valēre = to be strong

     dēbēre = to owe

The forms are present active infinitives of the 1st conjugation
3    vocāre   = to call

     servāre  = to save

     dare     = to give

     cōgitāre = to think

     laudāre  = to praise

     amāre    = to love

     errāre   = to err

The forms are present active imperatives 2nd person singular of the 1st or the 2nd conjugations.
4    vocā   = call

     servā  = save

     dā     = give

     cōgitā = think

     laudā  = praise

     amā    = love

     monē   = advise / warn

     vidē   = see

     valē   = be strong / good-bye

The forms are present active imperatives 2nd person plural of the 1st or the 2nd conjugations
5    vocāte   = call

     servāte  = save

     date     = give

     cōgitāte = think

     laudāte  = praise

     amāte    = love

     monēte   = advise / warn

     vidēte   = see

     valēte   = be strong / good-bye

Translate the following words
6    vocat     = he / she / it / calls, is calling, does call

     cōgitāmus = we think

     amant     = they love

     dēbēs     = you (singular) owe / ought

     videt     = he sees

     vident    = they see

     dēbēmus   = we owe / ought

     valēs     = you (singular) are strong

     errātis   = you (plural) err / are mistaken

     vidēmus   = we see

     amat      = he / she /it loves

     vidētis   = you (plural) see

     errās     = you (singular) err

     dant      = they give

     servāmus  = we save

     dat       = he gives

     amant     = they love

     vidēs     = you (singular) see

7    Monent mē sī errō = They warn me if I err.

8    Monet mē sī errant = He warns me if they err.

9    Monēte mē sī errat = Warn me if he errs.

10    Dēbēs monēre mē = You (singular) ought to warn me.

11    Dēbētis servāre mē = You (plural) ought to save me.

12    Nōn dēbent laudāre mē = They ought not to praise me.

13    "Quid dat?" "Saepe nihil dat" = "What does he give?" "He often gives nothing."

14    Mē saepe vocant et monent = They often call me and advise me.

15    Nihil videō. Quid vidēs? = I see nothing. What do you see?

16    Mē laudā sī nōn errō amābō tē = Praise me, please, if I do not make a mistake.

17    Sī valētis, valēmus = If you (plural) are well, we are well.

18    Sī valet, valeō = If he is well, I am well.

19    Sī mē amat, dēbet mē laudāre = If he (she) loves me, he (she) ought to praise me.

20    Cōnservāte mē = Save me.

21    Nōn dēbeō errāre = I ought not to err.

22    Quid dēbēmus laudāre? = What ought we to praise?

23    Videt; cōgitat; monet = He sees; he ponders; he advises